11111111111111111111111
11000000000000C00000001
10000000000001000000001
10000000000000000000001
100000000000E1000000001
10000000000000000000001
1P000000000000000000001
11111111111111111111111