11111111111111111111111
11000000000000C00000001
10000000000001000000001
10000000000000000000001
10000000000001000000001
10000000000000000000011
1P0000000000000000000E1
11111111111111111111111