1111111111111111111
1CCCCCCCC1CC0CCCCC1
1C11C111C1C111C11C1
1011011101011101101
1000000000000000001
1011010111110101101
1000010001000100001
1111011101011101111
1001010000000101001
111101011011010E111
1000P0010C010000001
1111010110110101111
1001010000000101001
1111010111110101111
1000000001000000001
1011011101011101101
1001000000000001001
1101010111110101011
1000010001000100001
1011111101011111101
1000000000000000001
1111111111111111111