11111111111111111111
11000000000000000001
10000100000000000001
10000000000000001001
10001000000001000001
10000000100000000001
10110001100010000P01
10000000000110000001
10011000000000011001
10001000M01000000001
10000000000000000001
10000010100000000001
100000C0000000100001
10000010C000011000M1
1000000000M000010001
10001000000000E10001
100M1100000001000001
11111000010010C00001
11111000010000000001
11111111111111111111