111111111111111111111
111111111111111111111
101000000000001000101
110001000001110101001
101000000100011000101
110000000000000010001
100100000000000100001
1100000110C0001000001
101101C01011000000011
1000000C0001000000001
100000001100001010001
100001001000000110001
110000000100000001001
1000C0100000000001001
1001000000100E0000C11
100M00000100010000101
10010000P011000000001
110000C00010001110101
111111111111111111111
111111111111111111111
111111111111111111111