111111111111111111
111111111111111111
10011010000001E001
110000000000001001
1000010000M0000001
10M000C00000100011
1000001000000000C1
1P00M0000000000011
1110000000000000M1
100000000000010001
100000000100000001
1000010C0100100101
100000000000000001
100001000000000001
110000000000000001
111111111111111111
111111111111111111
111111111111111111